19
WWWWWWWWWWWWWWWWWWW
W___III_IIIII__I__W
W_WIWIWIWIW_W_W_W_W
WIIIIII_II______IIW
WIWIWIW_W_W_W_WIWIW
WIIIIII________IIIW
WIWIWIW_W_W_W_WIWIW
WIIII_I_III_____IIW
WIWIWIW_WIW_W_WIWIW
WIIIIIIIII___IIII_W
WIWIWIWIW_W_WIWIW_W
WII_II___I___II___W
WIWIW_WIW_WIWIWIW_W
W__III______III_IIW
W_WIWIWIW_W_W_WIWIW
WIIIIIIII_____III_W
W_WIWIWIW_W_WIWIW_W
W__IIII___I_IIII__W
WWWWWWWWWWWWWWWWWWW
