19
WWWWWWWWWWWWWWWWWWW
W_____I_IIII__I___W
WIW_W_WIWIWIWIW_W_W
WII_I_IIIIIIIIII__W
W_W_WIWIWIWIWIWIW_W
W__IIII_I_____II_IW
WIWIWIW_WIW_W_W_WIW
WIIII___IIIII_II_IW
WIWIWIWIWIWIWIWIWIW
WIIIIIIIIIIIIIII__W
WIWIWIWIWIWIWIWIW_W
WIIIIIIIIIIIIIII__W
WIWIWIW_WIW_WIWIW_W
WIIIII_______I_IIIW
WIWIWIWIW_W_W_WIWIW
WIIIIIIIIII_____IIW
W_WIWIWIWIWIW_W_W_W
W__IIIIIIIIII_II__W
WWWWWWWWWWWWWWWWWWW
